........
........
...XXX..
...X....
........
